0 0 0 0 0 0 0 0 0 0 0 0 0 0 0 0
0 0 0 0 0 0 0 0 0 0 0 0 0 0 0 0
0 0 0 0 0 0 0 0 0 0 0 0 0 0 0 0
0 1 2 4 5 6 7 0 10 0 0 0 0 12 13 0
0 3 0 0 0 8 9 0 11 19 21 22 23 14 15 0
26 16 0 28 0 17 18 29 20 0 0 0 0 24 25 0
0 27 0 0 0 0 30 0 0 0 0 0 0 31 0 0
