0 0 0 0 0 0 0 0 0 0 0 0 0 0 0 0 0 0 0 0 0 0 0 0 0 0 0 0
0 0 0 0 0 0 0 0 0 0 0 0 0 0 0 0 0 0 0 0 0 0 0 0 0 0 0 0
0 0 0 0 0 0 0 0 0 0 0 0 0 0 0 0 0 0 0 0 0 0 0 0 0 0 0 0
0 0 0 0 0 0 0 0 0 0 0 0 0 0 0 0 0 0 0 0 0 0 0 0 0 0 0 0
0 1 - - - - 2 - - - - - 4 0 0 7 - - - - - 8 - - - - 10 0
0 | 0 0 0 0 | 0 0 0 0 0 | 0 0 | 0 0 0 0 0 | 0 0 0 0 | 0
0 | 0 0 0 0 | 0 0 0 0 0 | 0 0 | 0 0 0 0 0 | 0 0 0 0 | 0
0 | 0 0 0 0 | 0 0 0 0 0 | 0 0 | 0 0 0 0 0 | 0 0 0 0 | 0
0 3 - - - - 5 - - 14 - - 6 - - 9 - - 17 - - 11 - - - - 12 0
0 | 0 0 0 0 | 0 0 | 0 0 0 0 0 0 0 0 | 0 0 | 0 0 0 0 | 0
0 | 0 0 0 0 | 0 0 | 0 0 0 0 0 0 0 0 | 0 0 | 0 0 0 0 | 0
0 13 - - - - 15 0 0 16 - - 22 0 0 24 - - 18 0 0 19 - - - - 20 0
0 0 0 0 0 0 | 0 0 0 0 0 | 0 0 | 0 0 0 0 0 | 0 0 0 0 0 0
0 0 0 0 0 0 | 0 0 0 0 0 | 0 0 | 0 0 0 0 0 | 0 0 0 0 0 0
0 0 0 0 0 0 | 0 0 27 - - 23 - - 25 - - 29 0 0 | 0 0 0 0 0 0
0 0 0 0 0 0 | 0 0 | 0 0 0 0 0 0 0 0 | 0 0 | 0 0 0 0 0 0
0 0 0 0 0 0 | 0 0 | 0 0 0 0 0 0 0 0 | 0 0 | 0 0 0 0 0 0
31 - - - - - 21 - - 28 0 0 0 0 0 0 0 0 30 - - 26 - - - - - 35
0 0 0 0 0 0 | 0 0 | 0 0 0 0 0 0 0 0 | 0 0 | 0 0 0 0 0 0
0 0 0 0 0 0 | 0 0 | 0 0 0 0 0 0 0 0 | 0 0 | 0 0 0 0 0 0
0 0 0 0 0 0 | 0 0 33 - - - - - - - - 34 0 0 | 0 0 0 0 0 0
0 0 0 0 0 0 | 0 0 | 0 0 0 0 0 0 0 0 | 0 0 | 0 0 0 0 0 0
0 0 0 0 0 0 | 0 0 | 0 0 0 0 0 0 0 0 | 0 0 | 0 0 0 0 0 0
0 39 - - - - 32 - - 37 - - 42 0 0 44 - - 38 - - 36 - - - - 46 0
0 | 0 0 0 0 | 0 0 0 0 0 | 0 0 | 0 0 0 0 0 | 0 0 0 0 | 0
0 | 0 0 0 0 | 0 0 0 0 0 | 0 0 | 0 0 0 0 0 | 0 0 0 0 | 0
0 40 - 49 0 0 41 - - 51 - - 43 - - 45 - - 54 - - 47 0 0 57 - 48 0
0 0 0 | 0 0 | 0 0 | 0 0 0 0 0 0 0 0 | 0 0 | 0 0 | 0 0 0
0 0 0 | 0 0 | 0 0 | 0 0 0 0 0 0 0 0 | 0 0 | 0 0 | 0 0 0
0 59 - 50 - - 52 0 0 53 - - 61 0 0 63 - - 55 0 0 56 - - 58 - 65 0
0 | 0 0 0 0 0 0 0 0 0 0 | 0 0 | 0 0 0 0 0 0 0 0 0 0 | 0
0 | 0 0 0 0 0 0 0 0 0 0 | 0 0 | 0 0 0 0 0 0 0 0 0 0 | 0
0 60 - - - - - - - - - - 62 - - 64 - - - - - - - - - - 66 0
0 0 0 0 0 0 0 0 0 0 0 0 0 0 0 0 0 0 0 0 0 0 0 0 0 0 0 0
0 0 0 0 0 0 0 0 0 0 0 0 0 0 0 0 0 0 0 0 0 0 0 0 0 0 0 0
0 0 0 0 0 0 0 0 0 0 0 0 0 0 0 0 0 0 0 0 0 0 0 0 0 0 0 0
